ПІБ										слова від - до
Рибчак Христина Василівна			пов'язуватися - посильний
Луньо Анна Іванівна					підліток - пов'язувати
Савіцька Ольга Юріївна				перекусити - підлість
Гречух Юлія Андріївна				пака - перекручувач
Іваськів Марта Євгенівна			окиснення - падчерка
Стецьків Олена Олегівна				обдерти - ознака
Лещишин Христина Олегівна			неміч - обгоряти
Зварич Оксана Ігорівна				настирливий - неминучий
Олійник Ілона Василівна				надихувати - настилати
Бурдико Анастасія Юріївна			молодість - надихнутися
Стефанко Христина Василівна			лущитися - молодий
Саган Анастасія Юріївна				культура - лущити
Василів Марта Карлівна				кольоровий - культиватор
Кривюк Мирослава-Стефанія Петрівна	іспит - колупати		
Турчиняк Ольга Іванів				наземний - існування
Мирон Ярина Андріївна				засновник - земляк
Попович Анна Євгеніївна				задерикуватий - засмучуватися
Свіляк Оксана Юріївна				експедиція - задерев'яніти
Стефанюк Оксана Володимирівна		доброволець - експансивний
Липак Олена Володимирівна			гузир - добровільний
Павлів Ірина Олегівна				гарцювати - гудіти
Олесюк Галина Павлівна				влучати - гартуватися
Білик Дмитро Гайович				відкритися - влітати
Михайлів Роксолана Богданівна		виступати - відкритий
Щур Надія Миколаївна				викручувати - виступ
Билень Ірина Андріївна				ведмежатина - викрутитися
Сайчук Ольга Володимирівна			божевільний - ведмежа
Гарбуз Лідія Вікторівна				бач - божевілля
Ліпковська Ірина Ярославівна		абетка - бахур

Василишин Вікторія					посилювати - прилетіти
Неїжмак Ольга						прилипати - пролазити



32 пролісок рогожа
33 рогулька рукав
34 рукописний скоком
35 скорбота спочатку
36 споювати суходіл
37 сухожилок тротуар
38 трохи уроздріб
39 урозсип хрусткий
40 хтивий щедрість
41 щербатий ящірка